11111111111111111111111111111111111111111111111111
100E0000000000000000000000000000000000000000000001
100000C0000000000000000000000000000000000000000001
10000000000000000000000000000000000000000000000001
10000000C00000000000000000000000000000000000000001
10000000000000000000000000000000000000000000000001
10000000000100000000000000000000000000000000000001
10000000001110000000000000000000000000000000000001
10000000011111000000000000000000000000000000000001
10000000000100000000000000000000000000000000000001
10000000000100000000000000000000000000000000000001
10000000000100000000000000000000000000000000000001
10000000000100000000000000000000000000000000000001
10000000000100000000000000000000000000000000000001
10000000000000000000000000000000000000000000000001
10000000000000000000000000000000000000000000000001
10000000000100000000000000000000000000000000000001
10000000001110000000000000000000000000000000000001
10000000011111000000000000000000000000000000000001
10000000000100000000000000000000000000000000000001
10000000000100000000000000000000000000000000000001
10000000000100000000000000000000000000000000000001
10000000000100000000000000000000000000000000000001
10000000000100000000000000000000000000000000000001
10000000000000000000000000000000000000000000000001
10000000000000000000000000000000000000000000000001
10000000000100000000000000000000000000000000000001
10000000001110000000000000000000000000000000000001
10000000011111000000000000000000000000000000000001
10000000000100000000000000000000000000000000000001
10000000000100000000000000000000000000000000000001
10000000000100000000000000000000000000000000000001
10000000000100000000000000000000000000000000000001
10000000000100000000000000000000000000000000000001
10000000000000000000000000000000000000000000000001
10000000000000000000000000000000000000000000000001
10000000000100000000000000000000000000000000000001
10000000001110000000000000000000000000000000000001
10000000011111000000000000000000000000000000000001
10000000000100000000000000000000000000000000000001
10000000000100000000000000000000000000000000000001
100000000001000000000000P0000000000000000000000001
10000000000100000000000000000000000000000000000001
10000000000100000000000000000000000000000000000001
10000000000000000000000000000000000000000000000001
10000000000000000000000000000000000000000000000001
10000000000000000000000000000000000000000000000001
10000000000000000000000000000000000000000000000001
10000000000000000000000000000000000000000000000001
11111111111111111111111111111111111111111111111111
