11111111111111111111111111111111111111111111111111111111111111111111111111111111111111111
100000000001000000000010000000000E0000000000000100000000000000100000000000100000000000011
10000000000000000000000000000000000000C00000000000000000000000000000000000000000000000001
110000000000P0000000000000000000C00000000000000000000000010000000000000000000000000000001
11111111111111111111111111111111111111111111111111111111111111111111111111111111111111111
