111111111
100000001
100000001
111000001
100010001
100000011
100000001
100010001
101000001
100000001
101100001
100000001
100000001
101000001
100000001
100000101
101100001
100000001
101000001
100001001
100000001
100C00001
110000001
10000C001
1E0000011
100000001
111000001
100000001
100000001
100000001
100110001
100000001
101000001
100000001
100000001
100000111
100000001
101000001
100000001
100000001
1000P0001
100000001
100000111
100000001
111000001
100000001
100000001
110000001
111111111
