1111111
10P0001
101E001
10P0001
1111111
