1111111
1000001
101E001
1C000P1
0111111
