1111110
1000001
101E001
1C000P1
1111111
