1111111
1000001
001E001
1C000P1
1111111
