1111111
1000001
101E000
1C000P1
1111111
