1111111
1000001
101E001
1C0X0P1
1111111
