1111111
1000001
101E001
10000P1
1111111
