1111111
1000001
1010001
1C000P1
1111111
