1111111
1000001
101E001
1000001
1111111
