1111111
100001
101E011
1C000P1
1111111
